NO textures/.png
SO textures/.png
WE textures/.png
EA textures/.png

C 0,0,33
F 60,179,110


111111111111111111111111111
100000000011000S0000000011
00110000011100000000000011
00010000000000001000000011
1111111110110000111000011
10000000001100000111011111
11110111111101011100000011
11110111100001101110101001
11110111100001101110101001
11110111100001101110101001
11110111100001101110101001
11110111100001101110101001
11110111100001101110101001
11110111100001101110101001
11110111100001101110101001
11000001110101011111010011
 11111111111111111111111111