NO textures/blue_wall.png
SO textures/brick_wall.png
WE textures/steel_wall.png
EA textures/grey_wall.png

C 192,192,192
F 128,128,128


        11111111111111111111111111
        100000000011100000000000001
        111100000111110000000000001
        110100000000000000S0000011
111111111111000001110000000000001
110000000011000001110111110111111
11110111111111011100000010001
11110111111111011101010010001
11000000110101011100000010001
10000000000000001100000010001
10000000000000001101010010001
1100000111010101111101111000111
11110111 10110101 11111010001
11111111 1111111 111111111111