NO textures/.png
SO textures/.png
WE textures/.png
EA textures/.png

C 0,0,33
F 60,179,110


111111111111111111111111111
100000000011000S0000000011
10110000011100000000000011
11010000000000001000000011
1111111110110000111000011
1000 000001100000111011111
11110111111101011100000011
11110111100001101110101001
11110111100001101110101001
11110111100001101110101001
11110111100001101110101001
11110111100001101110101001
11110111100001101110101001
11110111100001101110101001
11110111100001101110101011
11000001110101011111010011
 111111111111111111111111