NO textures/north.png
SO textures/south.png
WE textures/west.png
EA textures/east.png

C 255,255,255
F 60,179,255


        11111111111111111111111111
        10000000000000000000000001
        1000000000000N000000000001
        1000000000000000000000001
1111111111111111111111111111111111
