NO textures/.png
SO textures/.png
WE textures/.png
EA textures/.png

C 0,0,33
F 60,179,110

1111
1  1
1011
1N11
1111